000000000000000000000000000000
000000000000000000000000000000
000000000000000000000000000000
000000000000000000000000000000
000000022222000000000000000000
000000000000000000000000000000
230000000000000004200000043000
11222222222222222110000221100
111111111111111111100001111300
111111111111111111100000110000
111111111111111111100000100000
111111111111111111100000100000
111111111111111111100000000000
