000000000000000000000000000000
000000000000000000000000000000
000000000000000000000000000000
000000000000000000000000000000
000000011111000000000000000000
000000000000000000000000000000
110000000000000001100000011000
11111111111111111110000111100
111111111111111111100001111100
111111111111111111100000110000
111111111111111111100000100000
111111111111111111100000100000
111111111111111111100000000000
